111111111111
1000P0000001
1C0000E00001
111111111111