111111111111111111111111111111
100000000000000000E00000000001
100000000000000000C00000000001
100000000000000000000000000001
100000000000000000000000000001
10000000P0000000C00000000000C1
100000000000000000000000000001
111111111111111111111111111111