111111111111
1000P0000001
1C00000000E1
111111111111